wwwwwwwwwwwwwwwwwwwwwwwwwww
w........................ow
w.................wswwwwwww
w..................s......w
w..................s....m.w
w..............wwwwswwwww.w
w..................s......w
w..k...m...........s......w
wwwwwwwwsww........s......w
w.......s..........s......w
w.......s..........s......w
w....wwwwsww.....wwwwwwwwww
w........s......w.........w
w........s.m...w..........w
w.......wswwwwwwwww.......w
w........s...............iw
wwwwwwwwwwwwwwwwwwwwwwwwwww
