wwwwwwwwwwwwwwwwwwwwwwwwwww
w........................ow
w.................wswwwwwww
w..................s......w
w.......ssssssss...s....m.w
w.......s......wwwwswwwww.w
w.......s..........s......w
w.k.....s..........s......w
wwwwwwwwsww........s......w
w.......s..........s......w
w.......s..........s......w
w.swswwwwsww.....wwwwwwwwww
w...s....s................w
w...s....s................w
w...s...wswwwwwwwww.......w
w........s...............iw
wwwwwwwwwwwwwwwwwwwwwwwwwww
