wwwwwwwwwwwwwwwwwwwwwwwwwwwwwww
w..........................k..w
w.............................w
w......................wswwww.w
w.......................s.....w
w.......................s...m.w
w...................ww.wwwsww.w
wo...............ww.......s...w
wwwwwwwwwwwwswww..........s...w
w...........s........sw...s...w
w...........s.............s...w
w..........wwswwwwwsww..wwwww.w
w............s.....s..........w
w...........ms.....s..........w
w.wwwswww..wwwwwwwwwww........w
w....s.......................iw
wwwwwwwwwwwwwwwwwwwwwwwwwwwwwww
